hex
bf7fff6e
90000000
3f7fff6e
90000000
9c800000
0
bc160020
d0000000
bb960020
d0000000
b71149fb
d0000000
371149fb
d0000000
1c000000
0
3a630399
80000000
ba630399
80000000
bbb26094
10000000
bc326094
10000000
3f7fff6e
90000000
bf7fff6e
90000000
1c800000
0
3c160020
d0000000
3b960020
d0000000
371149fb
d0000000
b71149fb
d0000000
9c000000
0
ba630399
80000000
3a630399
80000000
3bb26094
10000000
3c326094
10000000
3f7fff6e
90000000
bf7fff6e
90000000
bb960020
d0000000
3b960020
d0000000
371149fb
d0000000
b71149fb
d0000000
ba630399
80000000
3a630399
80000000
3bb26094
10000000
bbb26094
10000000
3f800000
0
3f800000
0
bf800000
0
bf800000
0
0
0
0
0
0
0
0
0
0
0
0
0
0
0
0
0
0
0
0
0
0
0
0
0
0
0
0
0
0
0
0
0
0
0
0
0
0
0
0
0
0
0
0
0
0
0
0
0
